# # # # # # # # # # # # # # # # # # # # # # # # # # # # # # # # # # # # # # # # # # # # # # # # # # # # # # # # # # # # # # # # 
# #                                                                                                                     # # # # 
#                                                                                                                           # # 
#                                                                                                                             # 
#                                           #                                                                                 # 
#                 G                         #                                                                                 # 
#                                         # #                                                                                 # 
#                                 # # # # #                                                                                   # 
#                             # # # #                                                             !                           # 
#                           #                                                                                                 # 
#                        #                                           #                                                        # 
#                                                                   #                                                         # 
#             # #                                                 # #                                                         # 
#         # # #                                                     # #                                                       # 
#     # # #                                                           # #                                                     # 
#                                                                       # # #                                               # # 
#                                                                           # # # # # # #                               # # # # 
#                                                                                       # # # # # # # # #         # # # # # # # 
#                                                                                             # # # #                 # # # # # 
#                                                     #                                                                     # # 
#                       !                           #                                                                         # 
#                                         # # # # #                                                                           # 
#                                       # # #                                           # # # # # #                           # 
#                                       # #                                       # # # #                             #       # 
#                                     # #                                   # #                                     #         # 
#                                   # #                                 #                                         # #         # 
#                               # # # #                                                                           #           # 
#                           # # #                                                                               # #           # 
#           # #           # #                                                                               # # #             # 
#             # # # #   # # #                               !                             #           # # # # #               # 
#                 # #                                                                   #       # # # #                       # 
#                                                                                     #       # #                             # 
#                                                                                     #     # #                               # 
#                                         #                                         # #     #                                 # 
#                                           #                                 # # # #                                         # 
#                                             # #                       # # # #                                               # 
#                                                 #                   # #                                                     # 
#                                                                   # #                                                       # 
#                                                                   #                             !                           # 
#                                                                   #                                                         # 
#                                                                 # #                                                         # 
#                     #                                         # #                                                           # 
#                     #                                                                                                       # 
#                     #                                                                                                       # 
#                       #                                                                                                     # 
#                         # #                                                                                                 # 
#                           # # #                                                                                             # 
#                               # #                                                                                           # 
#                                 #                                                                                           # 
#                                   #                                                                                         # 
#                                     #                                                                                       # 
#                   !                 #                                                                                       # 
#                                     #                                                                         #             # 
#                                     #                                                                       #               # 
#                                                                                                       # # #                 # 
#                                                                                             # # # # #           !           # 
#                                                                                                                             # 
#                                                                                                                             # 
#                                                                             # #                                 R           # 
#                                                                         # #                                                 # 
#                                                                   # # #             !                                       # 
#                                                                                                                             # 
# # #                                                                                                                       # # 
# # # # # # # # # # # # # # # # # # # # # # # # # # # # # # # # # # # # # # # # # # # # # # # # # # # # # # # # # # # # # # # # 